Average,High,Low,Very High,Very Low
1,0,0,0,0
0,1,0,0,0
1,0,0,0,0
0,0,0,1,0
0,1,0,0,0
0,0,1,0,0
0,0,0,1,0
0,0,0,1,0
0,0,1,0,0
0,1,0,0,0
1,0,0,0,0
0,0,0,0,1
0,0,0,0,1
0,0,0,0,1
0,1,0,0,0
0,0,1,0,0
0,1,0,0,0
1,0,0,0,0
0,1,0,0,0
0,0,0,0,1
0,0,0,0,1
0,1,0,0,0
0,0,0,0,1
0,0,1,0,0
0,1,0,0,0
0,0,0,1,0
0,0,1,0,0
0,0,0,0,1
0,1,0,0,0
0,1,0,0,0
1,0,0,0,0
1,0,0,0,0
0,1,0,0,0
0,1,0,0,0
0,0,0,1,0
0,1,0,0,0
1,0,0,0,0
0,0,1,0,0
1,0,0,0,0
1,0,0,0,0
0,0,0,0,1
0,0,0,0,1
1,0,0,0,0
0,0,0,1,0
0,0,0,1,0
0,1,0,0,0
0,0,0,0,1
0,0,0,1,0
0,0,0,1,0
0,1,0,0,0
1,0,0,0,0
0,0,0,0,1
0,0,0,1,0
0,0,0,0,1
0,0,1,0,0
0,0,0,1,0
0,0,1,0,0
1,0,0,0,0
0,0,1,0,0
0,1,0,0,0
0,0,1,0,0
0,1,0,0,0
0,0,0,0,1
0,1,0,0,0
0,1,0,0,0
1,0,0,0,0
0,0,0,1,0
0,1,0,0,0
0,0,0,0,1
0,0,0,0,1
0,1,0,0,0
0,0,0,0,1
0,0,0,1,0
0,1,0,0,0
0,0,0,0,1
0,0,1,0,0
0,0,1,0,0
0,0,1,0,0
1,0,0,0,0
1,0,0,0,0
0,0,1,0,0
0,0,0,0,1
0,0,0,1,0
1,0,0,0,0
0,0,1,0,0
0,0,0,1,0
1,0,0,0,0
0,0,1,0,0
